PWT|PURWAKARTA|
LMJ|LUMAJANG|
WON|WONOSARI|
PBL|PROBOLINGGO|
BDG|BANDUNG|
BGR|BOGOR|
DUN|MADIUN|
JOGJA|JOGJAKARTA|
KDR|KEDIRI|
KJT|KALIDJATI|
MDN|MEDAN|
MLG|MALANG|
PSR|PASURUAN|
SBG|SUBANG|
SMA|SEMARANG|
SOLO|SOLO|
SRB|SURABAYA|
SRG|SERANG|
CKG|CAKUNG|
CLP|CILACAP|
CSK|CISOKA|
SDG|SERDANG|
SOL|SOLO|
YKA|YOGYAKARTA|
JKT|JAKARTA|
SBY|SURABAYA|
LMP|LAMPUNG|
TNG|TANGERANG|
SKB|SUKABUMI|
CRB|CIREBON|
KLT|KALIMANTAN|
JMB|JAMBI|
BJM|BANJARMASIN|
TBN|TUBAN|
PKB|PEKANBARU|
SUMSEL|SUMATERA SELATAN|
PWK|PURWOKERTO|
JBR|JEMBER|
LMG|LAMONGAN|
DPS|DENPASAR|
SMD|SAMARINDA|
MGL|MAGELANG|
BTH|BATAM|
BLI|BALI|
PTNK|PONTIANAK|
BKS|BEKASI|
PKL|PEKALONGAN|
PLB|PALEMBANG|
PDG|PADANG|
