JKT|JAKARTA|
MDN|MEDAN|
SA|SOUTH ASIA|
SEA|SOUTH EAST ASIA|
JOGJA|JOGJAKARTA|
SOLO|SOLO|
BDG|BANDUNG|
SRB|SURABAYA|
TSK|TASIKMALAYA|
TNG|TANGERANG|
BGR|BOGOR|
SRG|SERANG|
SBG|SUBANG|
KJT|KALIDJATI|
SMA|SEMARANG|
MLG|MALANG|
KDR|KEDIRI|
PSR|PASURUAN|
DUN|MADIUN|
JBR|JEMBER|
BJM|BANJARMASIN|
MGL|MAGELANG|
DEN|DENPASAR|
PKT|PURWOKERTO|
LMJ|LUMAJANG|
SBY|SURABAYA|
LMP|LAMPUNG|
BKS|BEKASI|
TBN|TUBAN|
PKG|PEKALONGAN|
SKB|SUKABUMI|
PMB|PALEMBANG|
CRB|CIREBON|
JMB|JAMBI|
BJMSF||
PKB|PEKANBARU|
SUMSEL|SUMATERA SELATAN|
LMG|LAMONGAN|
BTH|BATAM|
SRD|SAMARINDA|
